00000000000010000000
00010001100000001111
00010000011000000000
11000001110000001111
10000000110000000000
10000111000001110000
10000011000001110000
00000000011110000000
00000000110000001111
00110000110000000000
00110000000000110000
00011000000001100000
00011000000001100000
01111000000110000000
00000000000000011000
00001111000000001000
00000000110001101000
10000000110001111000
10001100000000011001
11110000001100000001