00000100000011000000
00010000000000110000
00110000001100000000
01110000001100000000
00000000000000000000
00000111000001000000
00000010000001110000
00000111000001000000
00000000010000000000
00110000111000001100
00000001010100000000
00011000000001100000
00011000000001100000
00000000000000000000
00000110000000110000
00000000000000000000
00000000110000000000
00000000110000000000
00001100110000110000
00000000000000000000