00000100000000000000
00000000000000000000
00100000001100000000
00100000001100000000
00000000000000000000
00000010000000000000
00000010000000110000
00000000000000000000
00000000000000000000
00000000010000000000
00000000000000000000
00010000000000000000
00010000000000000000
00000000000000000000
00000110000000110000
00000000000000000000
00000000000000000000
00000000010000000000
00000000010000000000
00000000000000000000