00000100110100000000
00100001000001000000
00100110001100100110
00000011101100000110
00110011100001110000
00110000000111011110
00000010000111011110
00001011010111011110
00001001001100000000
00001101001111000000
00000101100011000000
01110000101111000000
01110011101111000000
01110011111101010000
11000111111001000010
00000011100001110000
00000011100001111000
01100011101100001110
00000000000000000000
00000000011100000000