00000100000100000000
00100001000001000000
00100110000000100110
00000010000000000110
00000010000000000000
00110000000000010000
00000010000100000010
00001000000000010000
00001000000000000000
00000000001000000000
00000100000011000000
01010000000000000000
00010010000000000000
00000000000000000000
00000100000001000010
00000000100000010000
00000000000000000000
00000000000000000000
00000000011000000000
00000000010000000000