00000000000010000000
00010001100000000000
00010000011000000000
11000000000000001111
00000000000000000000
00000111000001110000
10000011000001110000
00000000011110000000
00000000110000000000
00110000110000000000
00110000000000110000
00011000000001100000
00011000000001100000
00000000000000000000
00000000000000011000
00000000000000001000
00000000110000001000
00000000110000001000
00001100000000011000
00000000000000000000