00000000000010000000
00010000000000000000
00010000011000000000
00000000000000000000
00000000000000000000
00000000000001000000
10000011000001000000
00000000000000000000
00000000000000000000
00110000000000000000
00000000000000000000
00000000000000000000
00000000000001100000
00000000000000000000
00000000000000000000
00000000000000001000
00000000000000001000
00000000110000001000
00000000000000010000
00000000000000000000