00000100000000000000
00010000000000110000
00110000001100000000
00000000000000000000
00000000000000000000
00000000000001000000
00000010000001000000
00000000000001000000
00000000010000000000
00000000000000001100
00000000000100000000
00011000000000000000
00000000000001100000
00000000000000000000
00000110000000110000
00000000000000000000
00000000110000000000
00000000110000000000
00000000110000000000
00000000000000000000