00000000000010000000
00010000000000000000
00010000011000000000
00000000000000000000
00000000000000000000
00000111000001000000
10000011000001000000
00000000000000000000
00000000110000000000
00110000110000000000
00000000000000000000
00011000000001100000
00011000000001100000
00000000000000000000
00000000000000011000
00000000000000001000
00000000110000001000
00000000110000001000
00001100000000011000
00000000000000000000